###....###
#........#
#....#...#
.........
#..#@#.#.
.
...#..#...
....
#........#
#........#
###....###